 1s2.2s        2S       2      0.0000    021
 1s2.2p        2Po      2     13.9185    021
 1s2.2p        2Po      4     14.0395    021
 1s2.3s        2S       2    105.9595    021
 1s2.3p        2Po      2    109.7419    021
 1s2.3p        2Po      4    109.7773    021
 1s2.3d        2D       4    111.0426    021
 1s2.3d        2D       6    111.0534    021
 1s2.4s        2S       2    141.3955    021
 1s2.4p        2Po      2    142.9405    021
 1s2.4p        2Po      4    142.9550    021
 1s2.4d        2D       4    143.4806    021
 1s2.4d        2D       6    143.4850    021
 1s2.4f        2Fo      6    143.5145    021
 1s2.4f        2Fo      8    143.5145    021
 1s2.5s        2S       2    157.4452    021
 1s2.5p        2Po      2    158.2227    021
 1s2.5p        2Po      4    158.2306    021
 1s2.5d        2D       4    158.4975    021
 1s2.5d        2D       6    158.4999    021
 1s2.5f        2Fo      6    158.5159    021
 1s2.5f        2Fo      8    158.5159    021
 1s2.5g        2G       8    158.5184    021
 1s2.5g        2G      10    158.5184    021
 1s2.6s        2S       2    166.0507    021
 1s2.6p        2Po      2    166.4991    021
 1s2.6p        2Po      4    166.4991    021
 1s2.6d        2D       4    166.6545    021
 1s2.6d        2D       6    166.6558    021
 1s2.6f        2Fo      6    166.6654    021
 1s2.6f        2Fo      8    166.6654    021
 1s2.6g        2G       8    166.6669    021
 1s2.6g        2G      10    166.6669    021
 1s2.7s        2S       2    171.1943    021
 1s2.7p        2Po      2   [171.4748]   021
 1s2.7p        2Po      4   [171.4748]   021
 1s2.7d        2D       4    171.5729    021
 1s2.7d        2D       6    171.5729    021
 1s2.7f        2Fo      6    171.5794    021
 1s2.7f        2Fo      8    171.5794    021
 1s2.7g        2G       8   [171.5804]   021
 1s2.7g        2G      10   [171.5804]   021
 1s2.8s        2S       2   [174.5117]   021
 1s2.8p        2Po      2   [174.6988]   021
 1s2.8p        2Po      4   [174.6988]   021
 1s2.8d        2D       4    174.7643    021
 1s2.8d        2D       6    174.7643    021
 1s2.8f        2Fo      6    174.7687    021
 1s2.8f        2Fo      8    174.7687    021
 1s2.8g        2G       8    174.7693    021
 1s2.8g        2G      10    174.7693    021
 1s2.9f        2Fo      6    176.9553    021
 1s2.9f        2Fo      8    176.9553    021
 1s2.10f       2Fo      6    178.5194    021
 1s2.10f       2Fo      8    178.5194    021
 1s2.(1S<0>)   Limit         185.1867    021
